Note: Do not change the headings in this file, they are used to detect problems	
Status Bar Message	Tool Tip
Pour obtenir de l'aide, tapez F1	
Créer une nouvelle carte	Nouvelle carte [Ctrl+N]
Ouvrir une carte existante	Ouvrir une carte [Ctrl+O]
Sauvegarder la carte actuelle	Sauvegarder la carte [Ctrl+S]
Sauvegarder la carte actuelle sous un nouveau nom	Sauvegarder sous...
"Afficher des informations sur le programme, le numéro de version et le copyright"	À propos
Quitter l'éditeur de carte	Quitter
Lister les rubriques d'aide	Rubriques d'aide
Afficher l'aide de l'activité ou de la commande actuelle	Aide
Ouvrir cette carte	
Copier l'objet sélectionné et le mettre dans le presse-papier	Copier
Couper l'objet sélectionné et le mettre dans le presse-papier	Couper
Trouver un type d'objet spécifique	
Insérer le contenu du presse-papier	Coller
Annuler la dernière action	Annuler [Ctrl+Z]
Rétablir l'action précédemment annulée	Rétablir [Shift+Ctrl+Z]
Changer la taille de la fenêtre	
Changer la position de la fenêtre	
Réduire la fenêtre	
Élargir la fenêtre	
Fermer la fenêtre	
Restaurer la taille normale de la fenêtre	
Voir la carte souterraine	Souterrain [Ctrl+U]
Indiquer si les objets sont franchissables	Carte d'accessibilité
Placer du terrain	Outil de Terrain
Placer des rivières	Outil de Rivière
Placer des routes	Outil de Route
Effacer des objets	Gomme
Placer des objets de type Terre	Objets Terre [Q]
Placer des objets de type Désert	Objets Désert [W]
Placer des objets de type Prairie	Objets Prairie [E]
Placer des objets de type Neige	Objets Neige [R]
Placer des objets de type Marais	Objets Marais [T]
Placer des objets de type Rocailleux	Objets Rocailleux [Y]
Placer des objets de type Souterrain	Objets Souterrain [U]
Placer des objets de type Lave	Objets Lave [I]
Placer des objets de type Océan	Objets Océan []]
Placer des villes	Villes [S]
Placer des monstres	Monstres [D]
Placer des héros	Héros [F]
Placer des artéfacts	Artéfacts [G]
Placer des trésors	Trésors [H]
Animer les objets de la carte	
Modifier les spécifications de la carte	
Sélectionner le pinceau de taille 1x1	Pinceau de 1x1 [Z]
Sélectionner le pinceau de taille 2x2	Pinceau de 2x2 [X]
Sélectionner le pinceau de taille 4x4	Pinceau de 4x4 [C]
Selectionner la brosse de remplissage	Brosse de remplissage [V]
Sélectionner le terrain de type Terre	Terre [1]
Sélectionner le terrain de type Désert	Désert [2]
Sélectionner le terrain de type Prairie	Prairie [3]
Sélectionner le terrain de type Neige	Neige [4]
Sélectionner le terrain de type Marais	Marais [5]
Sélectionner le terrain de type Rocailleux	Rocailleux [6]
Sélectionner le terrain de type Souterrain	Souterrain [7]
Sélectionner le terrain de type Lave	Lave [8]
Sélectionner le terrain de type Océan	Océan
Sélectionner la rivière claire	Rivières claires [Alt+1]
Sélectionner la rivière gelée	Rivières gelées [Alt+2]
Sélectionner la rivière boueuse	Rivières boueuses [Alt+3]
Sélectionner la rivière de lave	Rivières de lave [Alt+4]
Sélectionner la route de gravier	Routes de gravier [Shift+2]
Sélectionner la route de pavés	Routes de pavés [Shift+3]
Sélectionner la gomme de 1x1	Pinceau de 1x1 [Shift+Z]
Sélectionner la gomme de 2x2	Pinceau de 2x2 [Shift+X]
Sélectionner la gomme de 4x4	Pinceau de 4x4 [Shift+C]
Selectionner la gomme de remplissage	Brosse de remplissage [Shift+V]
Ne pas sélectionner de joueur	
Sélectionner le joueur %s	
Sélectionner la route de terre	Routes de terre [Shift+1]
Sélectionner le terrain de type Parois	Parois [+]
Supprimer l'objet sélectionné	Supprimer
Afficher les propriétés de l'objet sélectionné	Propriétés
Afficher la grille de cases	Grille
Placer les objets tous terrains	Objets tous Terrains [A]
Sélectionner le pinceau de 1x1	Pinceau de 1x1 
Sélectionner le pinceau de 2x2	Pinceau de 2x2 
Sélectionner le pinceau de 4x4	Pinceau de 4x4 
Selectionner la brosse de remplissage	Brosse de remplissage
Chercher d'éventuels problèmes avec la carte	Valider la carte [M]
Animer le terrain de la carte	
Modifier les options de l'application	
Exporter le texte de la carte actuelle vers un fichier texte	
Importer le texte d'un fichier texte vers la carte actuelle	
Décrire l'objet actuellement sélectionné	
Trouver l'objet suivant du dernier type spécifié	
Trouver l'objet précédent du dernier type spécifié	
Faire un zoom arrière sur la carte	Zoom arrière
Faire un zoom avant sur la carte	Zoom avant
Afficher ou cacher la barre d'outils	Activer / Désactiver la barre d'outils
Afficher ou cacher la barre d'état	Activer / Désactiver la barre d'état
Afficher ou cacher la barre de mode	Activer / Désactiver la barre de mode
Placer les obstacles automatiquement	Outil Obstacles
Sélectionner la brosse solide 1x1	Brosse Solide 1x1 [Shift+Q]
Sélectionner la brosse solide 2x2	Brosse Solide 2x2 [Shift+W]
Sélectionner la brosse solide 4x4	Brosse Solide 4x4 [Shift+E]
Sélectionner la brosse solide de remplissage	Brosse Solide de remplissage [Shift+R]
Sélectionner la brosse floue 1x1	Brosse Floue 1x1 [Shift+Alt+Q]
Sélectionner la brosse floue 2x2	Brosse Floue 2x2 [Shift+Alt+W]
Sélectionner la brosse floue 4x4	Brosse Floue 4x4 [Shift+Alt+E]
Sélectionner la brosse floue de remplissage	Brosse Floue de remplissage [Shift+Alt+R]
Sélectionner la gomme solide 1x1	Gomme Solide 1x1 [Shift+A]
Sélectionner la gomme solide 2x2	Gomme Solide 2x2 [Shift+S]
Sélectionner la gomme solide 4x4	Gomme Solide 4x4 [Shift+D]
Sélectionner la gomme solide de remplissage	Gomme Solide de remplissage [Shift+F]
Sélectionner la gomme floue 1x1	Gomme Floue 1x1 [Shift+Alt+A]
Sélectionner la gomme floue 2x2	Gomme Floue 2x2 [Shift+Alt+S]
Sélectionner la gomme floue 4x4	Gomme Floue 4x4 [Shift+Alt+D]
Sélectionner la gomme floue de remplissage	Gomme Floue de remplissage [Shift+Alt+F]
Placer les &Obstacles	Placer les &Obstacles [Shift+O]
Sélectionner la Gomme à Rivière	Gomme à Rivière [Alt+5]
Sélectionner la Gomme à Route	Gomme à Route [Shift+4]
Sélectionner le terrain de type Plateau	Plateau [9]
Placer des objets de type Plateau	Objets Plateau [O]
Sélectionner le terrain de type Aride	Aride [0]
Placer des objets de type Aride	Objets Aride [P]
Placer les Demeures des Créatures	Demeures des Créatures [J]
Placer les Portails Magiques	Portails Magiques [K]
Placer les Garnisons, Gardes Frontières-Quêtes, et Tentes	Garnisons, Gardes Frontières-Quêtes, et Tentes [L]
Placer les Terrains Magiques	Terrains Magiques [$]
Placer les Objets Décorations	Objets Décorations [^]
